###########   ###############
#    !                      #
#   ######                  #
#     D                     #
#   ######                  #
                            #
   @@@               @@@     
           #######           
#                           #
#          #######          #
#    !                      #
#                   ######  #
#             !             #
#                   ######  #
#          /                #
#############  ##############