###########   ###############
#    !                      #
#   ######                  #
#     D                     #
#   ######                  #
             /              #
             !               
           #######           
#                           #
#          #######          #
#                     !     #
#                   ######  #
#          !                #
#                   ######  #
#                           #
#############  ##############

