#################################
#       D                  !    #
#@@@@@@@@@@@@@@@@@@@@@@@@@@@@@@@#
#                               #
#    @@@@@@        @@@@@@       #
#    @    @        @    @       #
# !          @@@@           !   #
#    @    @        @    @       #
#    @@@@@@        @@@@@@       #
#                               #
#                               #
#                               #
#                               #
#/                              #
#################################
