#############################
#    !                      #
#   ######                  #
#     D                     #
#   ######                  #
#                           #
#            !              #
#          #######          #
#                           #
#          #######          #
#                     !     #
#                   ######  #
#          !                #
#                   ######  #
#                          /#
#############################

