#################################
#                               #
#                      @@@@@@@  #
#       !              @  D  @  #
#                      @     @  #
#                      @!    @  #
#                      @@@@@@@  #
#                               #
#@@@@@@@@@@@@@@@@@@@@@@@@@@@@@@@#
#/                              #
#                               #
#                             ! #
#################################