#################################
#                               #
#  @#@#@#@#@#@#@#@#@#@#@#@#@#   #
#  #  !                   D @   #
#  @                 !      #   #
#  #@#@#@#@#@#@#@#@#@#@#@#@#@   #
#                               #
#                               #
#                        !      #
#                               #
#                               #
#                               #
#      /                        #
#                               #
#################################